-L---L----L-
LLL-LLL--LLL
LLLSFSLLLLLL
LLLSWSLLLLLL
LLXSWSLLLLLL
FSFFWSLLLWWW
WSWLLSLLLW-P
WSWLLSLLLFSF
WSWLLSLLLLSL
WSWLXSLLLXSL
WSWFFFFFFFFF
WEW---------