------------
P-----------
F-F-F-F-FFSF
----L-----S-
---LLL----S-
FSFFLFFF-FFF
-S-LLL------
-SLLLLLX----
FFFFFFFFFFSF
---------WSW
---------WSW
---------WEW