---L---L----
--LLL-LLLG-P
FSFFFFFFFFFF
-S----L-----
-S---LLL----
-S--LLLLL-G-
FFFFFFFFFSFF
-----L---S--
----LLL--S--
E--LLLLL-S--
FFFFFFFFFFFF
------------