---L---L----
--LLL-LLL--P
FSFFFFFFFFFF
-S----L-----
-S---LLL----
-S--LLLLL-G-
FFFFFFFFFSFF
-----L---S--
----LLL--S--
E--LLLLLGS--
FFFFFFFFFFFF
------------