---L---L----
G-LLL-LLL--E
FSFFFFFFFFFF
-S----L-----
-S---LLL----
-S--LLLLL-G-
FFFFFFFFFSFF
-----L---S--
----LLL--S--
P--LLLLL-S--
FFFFFFFFFFFF
------------