-----L----E-
P---LLL---S-
FSFLLLLL-FSF
-SLLLLLLL-S-
-SLLLLLLLLS-
LSLLLLLLLLS-
LSLLLLLLLLSL
LSLLLLLLLLSL
LSLLLLLLLLSL
LSLLLLLXLLSL
FFFFFFFFFFFF