------------
E-----------
F-F-F-F-FFSF
----L-----S-
---LLL----S-
FSFFLFFF-FFF
-S-LLL------
-SLLLLLX----
FFFFFFFFFFSF
---------FSF
---------FYF