-E-L-W-L--L-
-SLLLWLLLLLZ
FSFFFWFFSFFF
-S-L-W--S-L-
-SLXLW--SLXL
FSFFFWFFSFFF
-SL--W--S-L-
-SLL-W--SLLL
LSLLLW-LSLLL
LSLLLGLLSLLL
FFFFFFFFFFFF
------------