-E-L-F-L--L-
-SLLLFLLLLLZ
FSFFFFFFSFFF
-S-L-F--S-L-
-SLXLF--SLXL
FSFFFFFFSFFF
-SL--F--S-L-
-SLL-F--SLLL
LSLLLF-LSLLL
LSLLLGLLSLLL
FFFFFFFFFFFF
------------