-L---L----L-
LLL-LLL--LLL
LLLSFSLLLLLL
LLLSWSLLLLLL
LLXSWSLLLLLL
FSFFWSLLLWWW
WSWLLSLLLW-E
WSWLLSLLLFSF
WSWLLSLLLLSL
WSWLXSLLLXSL
WYWFFFFFFFFF
WSW---------