-E----------
-S----------
-S----------
-S----------
FFFFWFFFFFSF
----W-L-W-S-
P---WLLLW-S-
FFS-WLLLW-S-
L-S-WLLLW-S-
LLSGLLLLLGS-
FFFFFFFFFFFF
------------