-----------P
---------SFF
---------S--
---------S--
---------S--
---------S--
F-FFFFFFFSFF
L--L--L--SL-
LLLLLLLL-SLL
ILXLLLLLLSLL
FFFFFFFFFFFF
------------