PG----------
FFFFFFFFFFSF
---L---L--S-
--XLL-LLL-S-
FSFFFFFFFFFF
-S-L----L---
-SLLL--LLLG-
FFFFFFFFFFSF
---L---L--S-
--LLLGLLL-S-
FSFFFFFFFFFF
-E----------